1111111111111
10000000000C1
10P0111111001
10C11E0000011
1111111111111
1111111111111
1111111111111
1111111111111
1111111111111
1111111111111
1111111111111
1111111111111
1111111111111