1111111111111
100100P0000C1
1000111111001
10C11E0000011
1111111111111
